1111111111
1S00000001
1000000001
10000000A1
1111111111
