NO ./assets/Wooden_Floor.xpm
SO ./assets/Brick_wall.xpm
WE ./assets/Metal_Floor.xpm
EA ./assets/Grass.xpm

F 0,0,0
C 220,220,200

1111111111
1000000001
10S0000001
1000000001
1000000001
1000000001111111
1000000000000001
1000000A00000001
1000000001111111
1000000001
1111111111
