111111 1111 11111111
10A00111001111100001111
100000N00000000010000011
100000000111111010011011
1111111111    1011111011
              1000011011
              1111111111  