111111 1111  
10A00111001111111
100000N0000000001
10000000011111101
1111111111    101111
              100001
              111111