111111
1S00011111
1000000001
1000000001
1000000001
1000000001
1000000001
1000000001
10000000A1
1111111111
