NO ./assets/Wooden_Floor.xpm
SO ./assets/Brick_wall.xpm
WE ./assets/Metal_Floor.xpm
EA ./assets/Grass.xpm

F 0,0,0
C 220,220,200

1111111111111111
1001000100010001
10S1010101000001
1001010101001001
10000100010000A1
1111111111111111
